BUDGET 200
XXXXXXXXXX
X........X
X.SPPPPPEX
X........X
XXXXXXXXXX