BUDGET 200
XXXXXXXXXXX
X.........X
X.SPPPPPE.X
X.........X
XXXXXXXXXXX