BUDGET 200
XXXXXXXXXX
X........X
X.SPPPP.EX
X........X
XXXXXXXXXX