BUDGET 265
.S.............X
.P...........PEX
.P...........P.X
.P...........P.X
.P...........P.X
.PPPPPPPPPPPPP.X
...............X
