BUDGET 420
SP.XXXXXXXXXXXXXXXXX
.P.X................
.P.XXXXXXXXXXXXXXXXX
.PPP.X.............X
.X.P.X..PPPPPPPPPP.X
.X.P.X..P........P.X
.X.PPPPPP.XXXX.PPP.X
.X.XXXXXX.XXXX.P.X.X
.X........XXXX.P.X.X
.XXXXXXXXXXXXX.PPPPP
................X..P
XXXXXXXXXXXXXXXXXX.E